AUDCAD_D	Wave5	Minimum	IT
AUDCHF_H1	WaveC	Minimum	IT
AUDCHF_H4	Wave4	Typical	LT
CADCHF_H1	Wave5	Minimum	ST
CADCHF_H4	Wave4	Minimum	LT
CHFJPY_H1	Wave4	Typical	IT
CHFJPY_H1	Wave4	Typical	LT
EURAUD_H4	Wave5	Minimum	IT
EURJPY_H1	Wave4	Minimum	LT
GBPAUD_H1	Wave4	Minimum	MT
GBPAUD_H4	Wave4	Minimum	LT
GBPCAD_D	WaveC	Typical	ST
GBPCHF_H1	Wave4	Minimum	ST
GBPJPY_H4	WaveC	Minimum	LT
GBPJPY_H4	WaveC	Minimum	MT
GBPJPY_D	WaveC	Minimum	ST
GBPNZD_H1	Wave5	Minimum	IT
GBPNZD_H1	Wave5	Minimum	LT
GBPNZD_H4	Wave5	Minimum	ST
GBPUSD_H4	WaveC	Minimum	MT
GBPUSD_D	WaveC	Minimum	ST
NZDCAD_H1	Wave4	Typical	MT
NZDCHF_D	Wave5	Minimum	IT
NZDJPY_H1	Wave4	Minimum	IT
NZDJPY_H1	Wave4	Minimum	LT
USDCAD_H4	Wave4	Typical	ST
USDCHF_H1	Wave4	Minimum	IT
USDCHF_H4	Wave4	Minimum	ST
USDJPY_H4	WaveC	Minimum	MT
